aa	aa	aa	aa
ae	ae	ae	ae
ah	ah	ah	ah
ao	ao	aa	ao
aw	aw	aw	aw
ax	ax	ah	ah
ax-h	ax	ah	ah
axr	er	er	er
ay	ay	ay	ay
b	b	b	b
bcl	vcl	sil	cl
ch	ch	ch	ch
d	d	d	d
dcl	vcl	sil	cl
dh	dh	dh	dh
dx	dx	dx	t
eh	eh	eh	eh
el	el	l	l
em	m	m	m
en	en	n	n
eng	ng	ng	ng
epi	epi	sil	sil
er	er	er	er
ey	ey	ey	ey
f	f	f	f
g	g	g	g
gcl	vcl	sil	cl
h#	sil	sil	sil
hh	hh	hh	hh
hv	hh	hh	hh
ih	ih	ih	ih
ix	ix	ih	ih
iy	iy	iy	iy
jh	jh	jh	jh
k	k	k	k
kcl	cl	sil	cl
l	l	l	l
m	m	m	m
n	n	n	n
ng	ng	ng	ng
nx	n	n	n
ow	ow	ow	ow
oy	oy	oy	oy
p	p	p	p
pau	sil	sil	sil
pcl	cl	sil	cl
q	cl	sil	sil
r	r	r	r
s	s	s	s
sh	sh	sh	sh
t	t	t	t
tcl	cl	sil	cl
th	th	th	th
uh	uh	uh	uh
uw	uw	uw	uw
ux	uw	uw	uw
v	v	v	v
w	w	w	w
y	y	y	y
z	z	z	z
zh	zh	sh	zh